Level2D
10
10
##########
#        #
#  ##### #
####     #
#        #
#        #
#    A   #
#@       #
#o       #
##########